iPhone=
iPhone 5=
iPad=
Google Nexus 4=
Google Nexus 5=
Google Nexus 7 (2012)=
Google Nexus 7 (2013)=
Google Nexus 10=
Google Glass=
Samsung Galaxy S2=
Samsung Galaxy S4=
2.7" QVGA Android Phone (240dp x 320dp: ldpi)=
3.2" QVGA Android Phone (320dp x 480dp: mdpi)=
3.3" WQVGA Android Phone (240dp x 400dp: ldpi)=
3.4" WQVGA Android Phone (240dp x 432dp: ldpi)=
5.1" WVGA Android Phone (480dp x 800dp: mdpi)=
5.4" FWVGA Android Phone (480dp x 856dp: mdpi)=
7.0" WSVGA Android Tablet (600dp x 1024dp: mdpi)=
10.1" WXGA Android Tablet (800dp x 1280dp: mdpi)=
Custom Device=
Digite o título da apresentação=Digite o título da apresentação
(Legenda da imagem)=(Legenda da imagem)
Ajuda=Ajuda
Arquivo=Arquivo
Editar=Editar
Visualizar=Visualizar
Apresentação sem título - Ninterpres=Apresentação sem título - Ninterpres
AbaArquivo=AbaArquivo
?=?
Autor(es):=Autor(es):
Título da apresentação:=Título da apresentação:
Mostrar transparência Nintersoft=Mostrar transparência Nintersoft
Mostrar logo Nintersoft=Mostrar logo Nintersoft
Mostrar data atual na última transparência=Mostrar data atual na última transparência
Ajustes adicionais:=Ajustes adicionais:
Tamanho da fonte:=Tamanho da fonte:
AbaEditar=AbaEditar
Selecione o tipo de transparência a ser modificada ou adicionada=Selecione o tipo de transparência a ser modificada ou adicionada
Imagem da transparência (Opcional)=Imagem da transparência (Opcional)
Título da Transparência=Título da Transparência
Conteúdo de texto da transparência=Conteúdo de texto da transparência
Salvar=Salvar
Limpar=Limpar
Mudar=Mudar
Criar=Criar
...=...
X=X
btExcluidados=btExcluidados
AbaVisualizar=AbaVisualizar
Previsualização=Previsualização
1024 x 768 - Padrão=1024 x 768 - Padrão
(16:9) - Tela cheia=(16:9) - Tela cheia
(4:3) - Não padrão=(4:3) - Não padrão
Aliceblue=Azul Alice
Antiquewhite=Branco antigo
Aqua=Água
Aquamarine=Água marinha
Azure=Azulado
Beige=Bege
Bisque=Bisque
Black=Preto
Blanchedalmond=Bisque claro
Blue=Azul
Blueviolet=Azul violeta
Brown=Marrom
Burlywood=Madeira robusta
Cadetblue=Cadete azul
Chartreuse=Verde intenso
Chocolate=Chocolate
Coral=Coral
Cornflowerblue=Canto de flor azul
Cornsilk=Canto de seda
Crimson=Carmesim
Darkblue=Azul escuro
Darkcyan=Ciano escuro
Darkgoldenrod=Haste dourada escura
Darkgray=Cinza escuro
Darkgreen=Verde escuro
Darkkhaki=Caqui escuro
Darkmagenta=Magenta escuro
Darkolivegreen=Verde oliva escuro
Darkorange=Laranja escuro
Darkorchid=Orquídea escura
Darkred=Vermelho escuro
Darksalmon=Salmão escuro
Darkseagreen=Verde oceânico escuro
Darkslateblue=Azul ardósia escuro
Darkslategray=Verde ardósia escuro
Darkturquoise=Turqueza escuro
Darkviolet=Violeta escuro
Deeppink=Rosa profundo
Deepskyblue=Azul céu profundo
Dimgray=Cinza escurecido
Dodgerblue=Azul trapaceiro
Firebrick=Quebra de fogo
Floralwhite=Branco floral
Forestgreen=Verde florestal
Fuchsia=Fúcsia
Gainsboro=Gainsb
Ghostwhite=Branco fantasma
Gold=Dourado
Goldenrod=Haste dourada
Gray=Cinza
Green=Verde
Greenyellow=Verde amarelado
Honeydew=Melado
Hotpink=Rosa intenso
Indianred=Vermelho índio
Indigo=Azul marinho
Ivory=Marfim
Khaki=Caqui
Lavender=Alfazema
Lavenderblush=Rubor alfazema
Lawngreen=Gramado verde
Lemonchiffon=Tecido de seda limão
Lightblue=Azul claro
Lightcoral=Coral claro
Lightcyan=Ciano claro
Lightgoldenrodyellow=Haste dourada clara
Lightgray=Cinza claro
Lightgreen=Verde claro
Lightpink=Rosa claro
Lightsalmon=Salmão claro
Lightseagreen=Verde oceânico claro
Lightskyblue=Azul céu claro
Lightslategray=Cinza ardósia claro
Lightsteelblue=Azul aço escuro
Lightyellow=Amarelo claro
Lime=Limão
Limegreen=Limão verde
Linen=Linho
Maroon=Castanho-avemelhado
Mediumaquamarine=Azul marinho médio
Mediumblue=Azul médio
Mediumorchid=Orquídea média
Mediumpurple=Roxo médio
Mediumseagreen=Verde oceânico médio
Mediumslateblue=Azul ardósia médio
Mediumspringgreen=Verde mola médio
Mediumturquoise=Turquesa médio
Mediumvioletred=Violeta avermelhado médio
Midnightblue=Azul meia-noite
Mintcream=Creme de menta
Mistyrose=Rosa enevoado
Moccasin=Mocasin
Navajowhite=Branco navaro
Navy=Marinho
Oldlace=Renda antiga
Olive=Oliva
Olivedrab=Oliva monótono
Orange=Laranja
Orangered=Laranja avermelhado
Orchid=Orquídea
Palegoldenrod=Haste dourada pálida
Palegreen=Verde pálido
Paleturquoise=Turquesa pálido
Palevioletred=Violeta avermelhado pálido
Papayawhip=Mamão papaya
Peachpuff=Sopro de pêssego
Peru=Peru
Pink=Rosa
Plum=Ameixa
Powderblue=Pó azul
Purple=Roxo
Red=Vermelho
Rosybrown=Marrom rosado
Royalblue=Azul real
Saddlebrown=Marrom selim
Salmon=Salmão
Sandybrown=Marrom arenoso
Seagreen=Verde oceânico
Seashell=Concha oceânica
Sienna=Siena
Silver=Prata
Skyblue=Azul céu
Slateblue=Azul ardósia
Slategray=Verde ardósia
Snow=Nevado
Springgreen=Mola verde
Steelblue=Azul aço
Tan=Bronzeado
Teal=Cerceta
Thistle=Cardo
Tomato=Tomate
Turquoise=Turquesa
Violet=Violeta
Wheat=Trigo
White=Branco
Whitesmoke=Branco fumaça
Yellow=Amarelo
Yellowgreen=Amarelo esverdeado
Null=Nulo
Cor tema da apresentação=Cor tema da apresentação
Código=Código
Aplicar à borda=Aplicar à borda
Aplicar à toda a apresentação=Aplicar à toda a apresentação
Aplicar à fonte=Aplicar à fonte
Cor do Texto=Cor do Texto
Config.=Config.
AbaAjuda=AbaAjuda
Site NS=Site NS
Ajuda Online=Ajuda Online
DocWiki=DocWiki
Suporte=Suporte
Email=Email
Sobre=Sobre
tbTeste=tbTeste
Atualizar=Atualizar
Source=
